#########################
#{...............M.....o#
#o.....................o#
#.######.##   ##.######.#
 .#    #.#     #.#    #. 
 .######.#######.######. 
#.......................#
#.......................#
#oM....................o#
#########################
